UPDATE CRM_opportunity
	SET 
	accountid = ISNULL((CASE WHEN @accountid = cast(cast(0 as binary) as uniqueidentifier) THEN NULL ELSE @accountid END), accountid),
	accountidname = ISNULL(@accountidname, accountidname),
	accountidyominame = ISNULL(@accountidyominame, accountidyominame),
	actualclosedate = ISNULL(@actualclosedate, actualclosedate),
	actualvalue = ISNULL(@actualvalue, actualvalue),
	actualvalue_base = ISNULL(@actualvalue_base, actualvalue_base),
	budgetamount = ISNULL(@budgetamount, budgetamount),
	budgetamount_base = ISNULL(@budgetamount_base, budgetamount_base),
	budgetstatus = ISNULL(@budgetstatus, budgetstatus),
	budgettypename = ISNULL(@budgettypename, budgettypename),
	campaignid = ISNULL((CASE WHEN @campaignid = cast(cast(0 as binary) as uniqueidentifier) THEN NULL ELSE @campaignid END), campaignid),
	campaignidname = ISNULL(@campaignidname, campaignidname),
	captureproposalfeedback = ISNULL(@captureproposalfeedback, captureproposalfeedback),
	captureproposalfeedbackname = ISNULL(@captureproposalfeedbackname, captureproposalfeedbackname),
	closeprobability = ISNULL(@closeprobability, closeprobability),
	completefinalproposal = ISNULL(@completefinalproposal, completefinalproposal),
	completefinalproposalname = ISNULL(@completefinalproposalname, completefinalproposalname),
	completeinternalreview = ISNULL(@completeinternalreview, completeinternalreview),
	completeinternalreviewname = ISNULL(@completeinternalreviewname, completeinternalreviewname),
	confirminterest = ISNULL(@confirminterest, confirminterest),
	confirminterestname = ISNULL(@confirminterestname, confirminterestname),
	contactid = ISNULL((CASE WHEN @contactid = cast(cast(0 as binary) as uniqueidentifier) THEN NULL ELSE @contactid END), contactid),
	contactidname = ISNULL(@contactidname, contactidname),
	contactidyominame = ISNULL(@contactidyominame, contactidyominame),
	--createdby = ISNULL((CASE WHEN @createdby = cast(cast(0 as binary) as uniqueidentifier) THEN NULL ELSE @createdby END), createdby),
	createdbyname = ISNULL(@createdbyname, createdbyname),
	createdbyyominame = ISNULL(@createdbyyominame, createdbyyominame),
	--createdon = ISNULL(@createdon, createdon),
	createdonbehalfby = ISNULL((CASE WHEN @createdonbehalfby = cast(cast(0 as binary) as uniqueidentifier) THEN NULL ELSE @createdonbehalfby END), createdonbehalfby),
	createdonbehalfbyname = ISNULL(@createdonbehalfbyname, createdonbehalfbyname),
	createdonbehalfbyyominame = ISNULL(@createdonbehalfbyyominame, createdonbehalfbyyominame),
	currentsituation = ISNULL(@currentsituation, currentsituation),
	customerid = ISNULL((CASE WHEN @customerid = cast(cast(0 as binary) as uniqueidentifier) THEN NULL ELSE @customerid END), customerid),
	customeridname = ISNULL(@customeridname, customeridname),
	customeridtype = ISNULL(@customeridtype, customeridtype),
	customeridyominame = ISNULL(@customeridyominame, customeridyominame),
	customerneed = ISNULL(@customerneed, customerneed),
	customerpainpoints = ISNULL(@customerpainpoints, customerpainpoints),
	DealerCode = ISNULL(@DealerCode, DealerCode),
	decisionmaker = ISNULL(@decisionmaker, decisionmaker),
	decisionmakername = ISNULL(@decisionmakername, decisionmakername),
	description = ISNULL(@description, description),
	developproposal = ISNULL(@developproposal, developproposal),
	developproposalname = ISNULL(@developproposalname, developproposalname),
	discountamount = ISNULL(@discountamount, discountamount),
	discountamount_base = ISNULL(@discountamount_base, discountamount_base),
	discountpercentage = ISNULL(@discountpercentage, discountpercentage),
	emailaddress = ISNULL(@emailaddress, emailaddress),
	estimatedclosedate = ISNULL(@estimatedclosedate, estimatedclosedate),
	estimatedvalue = ISNULL(@estimatedvalue, estimatedvalue),
	estimatedvalue_base = ISNULL(@estimatedvalue_base, estimatedvalue_base),
	evaluatefit = ISNULL(@evaluatefit, evaluatefit),
	evaluatefitname = ISNULL(@evaluatefitname, evaluatefitname),
	exchangerate = ISNULL(@exchangerate, exchangerate),
	filedebrief = ISNULL(@filedebrief, filedebrief),
	filedebriefname = ISNULL(@filedebriefname, filedebriefname),
	finaldecisiondate = ISNULL(@finaldecisiondate, finaldecisiondate),
	freightamount = ISNULL(@freightamount, freightamount),
	freightamount_base = ISNULL(@freightamount_base, freightamount_base),
	identifycompetitors = ISNULL(@identifycompetitors, identifycompetitors),
	identifycompetitorsname = ISNULL(@identifycompetitorsname, identifycompetitorsname),
	identifycustomercontacts = ISNULL(@identifycustomercontacts, identifycustomercontacts),
	identifycustomercontactsname = ISNULL(@identifycustomercontactsname, identifycustomercontactsname),
	identifypursuitteam = ISNULL(@identifypursuitteam, identifypursuitteam),
	identifypursuitteamname = ISNULL(@identifypursuitteamname, identifypursuitteamname),
	importsequencenumber = ISNULL(@importsequencenumber, importsequencenumber),
	initialcommunication = ISNULL(@initialcommunication, initialcommunication),
	initialcommunicationname = ISNULL(@initialcommunicationname, initialcommunicationname),
	isprivate = ISNULL(@isprivate, isprivate),
	isprivatename = ISNULL(@isprivatename, isprivatename),
	isrevenuesystemcalculated = ISNULL(@isrevenuesystemcalculated, isrevenuesystemcalculated),
	isrevenuesystemcalculatedname = ISNULL(@isrevenuesystemcalculatedname, isrevenuesystemcalculatedname),
	ktb_dnetid = ISNULL(@ktb_dnetid, ktb_dnetid),
	ktb_eventdata = ISNULL(@ktb_eventdata, ktb_eventdata),
	ktb_interfaceexceptionmessage = ISNULL(@ktb_interfaceexceptionmessage, ktb_interfaceexceptionmessage),
	ktb_isinterfaced = ISNULL(@ktb_isinterfaced, ktb_isinterfaced),
	ktb_isinterfacedname = ISNULL(@ktb_isinterfacedname, ktb_isinterfacedname),
	ktb_lostreason = ISNULL(@ktb_lostreason, ktb_lostreason),
	ktb_occuation = ISNULL(@ktb_occuation, ktb_occuation),
	ktb_occuationname = ISNULL(@ktb_occuationname, ktb_occuationname),
	ktb_progressstage = ISNULL(@ktb_progressstage, ktb_progressstage),
	ktb_progressstagename = ISNULL(@ktb_progressstagename, ktb_progressstagename),
	ktb_spkid = ISNULL((CASE WHEN @ktb_spkid = cast(cast(0 as binary) as uniqueidentifier) THEN NULL ELSE @ktb_spkid END), ktb_spkid),
	ktb_spkidname = ISNULL(@ktb_spkidname, ktb_spkidname),
	ktb_statusinterface = ISNULL(@ktb_statusinterface, ktb_statusinterface),
	ktb_statusinterfacename = ISNULL(@ktb_statusinterfacename, ktb_statusinterfacename),
	ktb_tempdocument = ISNULL(@ktb_tempdocument, ktb_tempdocument),
	ktb_tempdocumentname = ISNULL(@ktb_tempdocumentname, ktb_tempdocumentname),
	ktb_vehiclecategoryid = ISNULL((CASE WHEN @ktb_vehiclecategoryid = cast(cast(0 as binary) as uniqueidentifier) THEN NULL ELSE @ktb_vehiclecategoryid END), ktb_vehiclecategoryid),
	ktb_vehiclecategoryidname = ISNULL(@ktb_vehiclecategoryidname, ktb_vehiclecategoryidname),
	ktb_vehiclecolorname = ISNULL(@ktb_vehiclecolorname, ktb_vehiclecolorname),
	ktb_vehicledescription = ISNULL(@ktb_vehicledescription, ktb_vehicledescription),
	ktb_vehiclemodelid = ISNULL((CASE WHEN @ktb_vehiclemodelid = cast(cast(0 as binary) as uniqueidentifier) THEN NULL ELSE @ktb_vehiclemodelid END), ktb_vehiclemodelid),
	ktb_vehiclemodelidname = ISNULL(@ktb_vehiclemodelidname, ktb_vehiclemodelidname),
	lastonholdtime = ISNULL(@lastonholdtime, lastonholdtime),
	modifiedby = ISNULL((CASE WHEN @modifiedby = cast(cast(0 as binary) as uniqueidentifier) THEN NULL ELSE @modifiedby END), modifiedby),
	modifiedbyname = ISNULL(@modifiedbyname, modifiedbyname),
	modifiedbyyominame = ISNULL(@modifiedbyyominame, modifiedbyyominame),
	modifiedon = ISNULL(@modifiedon, modifiedon),
	modifiedonbehalfby = ISNULL((CASE WHEN @modifiedonbehalfby = cast(cast(0 as binary) as uniqueidentifier) THEN NULL ELSE @modifiedonbehalfby END), modifiedonbehalfby),
	modifiedonbehalfbyname = ISNULL(@modifiedonbehalfbyname, modifiedonbehalfbyname),
	modifiedonbehalfbyyominame = ISNULL(@modifiedonbehalfbyyominame, modifiedonbehalfbyyominame),
	msdyn_forecastcategory = ISNULL(@msdyn_forecastcategory, msdyn_forecastcategory),
	msdyn_forecastcategoryname = ISNULL(@msdyn_forecastcategoryname, msdyn_forecastcategoryname),
	name = ISNULL(@name, name),
	need = ISNULL(@need, need),
	needname = ISNULL(@needname, needname),
	onholdtime = ISNULL(@onholdtime, onholdtime),
	opportunityratingcode = ISNULL(@opportunityratingcode, opportunityratingcode),
	opportunityratingcodename = ISNULL(@opportunityratingcodename, opportunityratingcodename),
	originatingleadid = ISNULL((CASE WHEN @originatingleadid = cast(cast(0 as binary) as uniqueidentifier) THEN NULL ELSE @originatingleadid END), originatingleadid),
	originatingleadidname = ISNULL(@originatingleadidname, originatingleadidname),
	originatingleadidyominame = ISNULL(@originatingleadidyominame, originatingleadidyominame),
	overriddencreatedon = ISNULL(@overriddencreatedon, overriddencreatedon),
	ownerid = ISNULL((CASE WHEN @ownerid = cast(cast(0 as binary) as uniqueidentifier) THEN NULL ELSE @ownerid END), ownerid),
	owneridname = ISNULL(@owneridname, owneridname),
	owneridtype = ISNULL(@owneridtype, owneridtype),
	owneridyominame = ISNULL(@owneridyominame, owneridyominame),
	owningbusinessunit = ISNULL((CASE WHEN @owningbusinessunit = cast(cast(0 as binary) as uniqueidentifier) THEN NULL ELSE @owningbusinessunit END), owningbusinessunit),
	owningteam = ISNULL((CASE WHEN @owningteam = cast(cast(0 as binary) as uniqueidentifier) THEN NULL ELSE @owningteam END), owningteam),
	owninguser = ISNULL((CASE WHEN @owninguser = cast(cast(0 as binary) as uniqueidentifier) THEN NULL ELSE @owninguser END), owninguser),
	parentaccountid = ISNULL((CASE WHEN @parentaccountid = cast(cast(0 as binary) as uniqueidentifier) THEN NULL ELSE @parentaccountid END), parentaccountid),
	parentaccountidname = ISNULL(@parentaccountidname, parentaccountidname),
	parentaccountidyominame = ISNULL(@parentaccountidyominame, parentaccountidyominame),
	parentcontactid = ISNULL((CASE WHEN @parentcontactid = cast(cast(0 as binary) as uniqueidentifier) THEN NULL ELSE @parentcontactid END), parentcontactid),
	parentcontactidname = ISNULL(@parentcontactidname, parentcontactidname),
	parentcontactidyominame = ISNULL(@parentcontactidyominame, parentcontactidyominame),
	participatesinworkflow = ISNULL(@participatesinworkflow, participatesinworkflow),
	participatesinworkflowname = ISNULL(@participatesinworkflowname, participatesinworkflowname),
	presentfinalproposal = ISNULL(@presentfinalproposal, presentfinalproposal),
	presentfinalproposalname = ISNULL(@presentfinalproposalname, presentfinalproposalname),
	presentproposal = ISNULL(@presentproposal, presentproposal),
	presentproposalname = ISNULL(@presentproposalname, presentproposalname),
	pricelevelid = ISNULL((CASE WHEN @pricelevelid = cast(cast(0 as binary) as uniqueidentifier) THEN NULL ELSE @pricelevelid END), pricelevelid),
	pricelevelidname = ISNULL(@pricelevelidname, pricelevelidname),
	pricingerrorcode = ISNULL(@pricingerrorcode, pricingerrorcode),
	pricingerrorcodename = ISNULL(@pricingerrorcodename, pricingerrorcodename),
	prioritycode = ISNULL(@prioritycode, prioritycode),
	prioritycodename = ISNULL(@prioritycodename, prioritycodename),
	processid = ISNULL((CASE WHEN @processid = cast(cast(0 as binary) as uniqueidentifier) THEN NULL ELSE @processid END), processid),
	proposedsolution = ISNULL(@proposedsolution, proposedsolution),
	purchaseprocess = ISNULL(@purchaseprocess, purchaseprocess),
	purchaseprocessname = ISNULL(@purchaseprocessname, purchaseprocessname),
	purchasetimeframe = ISNULL(@purchasetimeframe, purchasetimeframe),
	purchasetimeframename = ISNULL(@purchasetimeframename, purchasetimeframename),
	pursuitdecision = ISNULL(@pursuitdecision, pursuitdecision),
	pursuitdecisionname = ISNULL(@pursuitdecisionname, pursuitdecisionname),
	qualificationcomments = ISNULL(@qualificationcomments, qualificationcomments),
	quotecomments = ISNULL(@quotecomments, quotecomments),
	resolvefeedback = ISNULL(@resolvefeedback, resolvefeedback),
	resolvefeedbackname = ISNULL(@resolvefeedbackname, resolvefeedbackname),
	RowStatus = ISNULL(@RowStatus, RowStatus),
	salesstage = ISNULL(@salesstage, salesstage),
	salesstagecode = ISNULL(@salesstagecode, salesstagecode),
	salesstagecodename = ISNULL(@salesstagecodename, salesstagecodename),
	salesstagename = ISNULL(@salesstagename, salesstagename),
	schedulefollowup_prospect = ISNULL(@schedulefollowup_prospect, schedulefollowup_prospect),
	schedulefollowup_qualify = ISNULL(@schedulefollowup_qualify, schedulefollowup_qualify),
	scheduleproposalmeeting = ISNULL(@scheduleproposalmeeting, scheduleproposalmeeting),
	sendthankyounote = ISNULL(@sendthankyounote, sendthankyounote),
	sendthankyounotename = ISNULL(@sendthankyounotename, sendthankyounotename),
	skippricecalculation = ISNULL(@skippricecalculation, skippricecalculation),
	skippricecalculationname = ISNULL(@skippricecalculationname, skippricecalculationname),
	slaid = ISNULL((CASE WHEN @slaid = cast(cast(0 as binary) as uniqueidentifier) THEN NULL ELSE @slaid END), slaid),
	slainvokedid = ISNULL((CASE WHEN @slainvokedid = cast(cast(0 as binary) as uniqueidentifier) THEN NULL ELSE @slainvokedid END), slainvokedid),
	slainvokedidname = ISNULL(@slainvokedidname, slainvokedidname),
	slaname = ISNULL(@slaname, slaname),
	SourceType = ISNULL(@SourceType, SourceType),
	stageid = ISNULL((CASE WHEN @stageid = cast(cast(0 as binary) as uniqueidentifier) THEN NULL ELSE @stageid END), stageid),
	statecode = ISNULL(@statecode, statecode),
	statecodename = ISNULL(@statecodename, statecodename),
	statuscode = ISNULL(@statuscode, statuscode),
	statuscodename = ISNULL(@statuscodename, statuscodename),
	stepid = ISNULL((CASE WHEN @stepid = cast(cast(0 as binary) as uniqueidentifier) THEN NULL ELSE @stepid END), stepid),
	stepname = ISNULL(@stepname, stepname),
	teamsfollowed = ISNULL(@teamsfollowed, teamsfollowed),
	timeline = ISNULL(@timeline, timeline),
	timelinename = ISNULL(@timelinename, timelinename),
	timespentbymeonemailandmeetings = ISNULL(@timespentbymeonemailandmeetings, timespentbymeonemailandmeetings),
	timezoneruleversionnumber = ISNULL(@timezoneruleversionnumber, timezoneruleversionnumber),
	totalamount = ISNULL(@totalamount, totalamount),
	totalamount_base = ISNULL(@totalamount_base, totalamount_base),
	totalamountlessfreight = ISNULL(@totalamountlessfreight, totalamountlessfreight),
	totalamountlessfreight_base = ISNULL(@totalamountlessfreight_base, totalamountlessfreight_base),
	totaldiscountamount = ISNULL(@totaldiscountamount, totaldiscountamount),
	totaldiscountamount_base = ISNULL(@totaldiscountamount_base, totaldiscountamount_base),
	totallineitemamount = ISNULL(@totallineitemamount, totallineitemamount),
	totallineitemamount_base = ISNULL(@totallineitemamount_base, totallineitemamount_base),
	totallineitemdiscountamount = ISNULL(@totallineitemdiscountamount, totallineitemdiscountamount),
	totallineitemdiscountamount_base = ISNULL(@totallineitemdiscountamount_base, totallineitemdiscountamount_base),
	totaltax = ISNULL(@totaltax, totaltax),
	totaltax_base = ISNULL(@totaltax_base, totaltax_base),
	transactioncurrencyid = ISNULL((CASE WHEN @transactioncurrencyid = cast(cast(0 as binary) as uniqueidentifier) THEN NULL ELSE @transactioncurrencyid END), transactioncurrencyid),
	transactioncurrencyidname = ISNULL(@transactioncurrencyidname, transactioncurrencyidname),
	traversedpath = ISNULL(@traversedpath, traversedpath),
	utcconversiontimezonecode = ISNULL(@utcconversiontimezonecode, utcconversiontimezonecode),
	versionnumber = ISNULL(@versionnumber, versionnumber),
	xjp_benefitforrepairabledamage = ISNULL(@xjp_benefitforrepairabledamage, xjp_benefitforrepairabledamage),
	xjp_benefitforrepairabledamagename = ISNULL(@xjp_benefitforrepairabledamagename, xjp_benefitforrepairabledamagename),
	xjp_bodilyinjurycompensation = ISNULL(@xjp_bodilyinjurycompensation, xjp_bodilyinjurycompensation),
	xjp_bodilyinjurycompensation_base = ISNULL(@xjp_bodilyinjurycompensation_base, xjp_bodilyinjurycompensation_base),
	xjp_bodilyinjurycompensationforonlypassengers = ISNULL(@xjp_bodilyinjurycompensationforonlypassengers, xjp_bodilyinjurycompensationforonlypassengers),
	xjp_bodilyinjurycompensationforonlypassengersname = ISNULL(@xjp_bodilyinjurycompensationforonlypassengersname, xjp_bodilyinjurycompensationforonlypassengersname),
	xjp_disastertotallossspecialagreement = ISNULL(@xjp_disastertotallossspecialagreement, xjp_disastertotallossspecialagreement),
	xjp_disastertotallossspecialagreementname = ISNULL(@xjp_disastertotallossspecialagreementname, xjp_disastertotallossspecialagreementname),
	xjp_firstdeductible = ISNULL(@xjp_firstdeductible, xjp_firstdeductible),
	xjp_firstdeductible_base = ISNULL(@xjp_firstdeductible_base, xjp_firstdeductible_base),
	xjp_firstregistration = ISNULL(@xjp_firstregistration, xjp_firstregistration),
	xjp_gradeprotection = ISNULL(@xjp_gradeprotection, xjp_gradeprotection),
	xjp_gradeprotectionname = ISNULL(@xjp_gradeprotectionname, xjp_gradeprotectionname),
	xjp_legalfee = ISNULL(@xjp_legalfee, xjp_legalfee),
	xjp_legalfeename = ISNULL(@xjp_legalfeename, xjp_legalfeename),
	xjp_passengerscoverageamount = ISNULL(@xjp_passengerscoverageamount, xjp_passengerscoverageamount),
	xjp_passengerscoverageamount_base = ISNULL(@xjp_passengerscoverageamount_base, xjp_passengerscoverageamount_base),
	xjp_personalliability = ISNULL(@xjp_personalliability, xjp_personalliability),
	xjp_personalliabilityname = ISNULL(@xjp_personalliabilityname, xjp_personalliabilityname),
	xjp_platenumbersegment1id = ISNULL((CASE WHEN @xjp_platenumbersegment1id = cast(cast(0 as binary) as uniqueidentifier) THEN NULL ELSE @xjp_platenumbersegment1id END), xjp_platenumbersegment1id),
	xjp_platenumbersegment1idname = ISNULL(@xjp_platenumbersegment1idname, xjp_platenumbersegment1idname),
	xjp_platenumbersegment2 = ISNULL(@xjp_platenumbersegment2, xjp_platenumbersegment2),
	xjp_platenumbersegment3 = ISNULL(@xjp_platenumbersegment3, xjp_platenumbersegment3),
	xjp_platenumbersegment4 = ISNULL(@xjp_platenumbersegment4, xjp_platenumbersegment4),
	xjp_repurchasenewvehicle = ISNULL(@xjp_repurchasenewvehicle, xjp_repurchasenewvehicle),
	xjp_repurchasenewvehiclename = ISNULL(@xjp_repurchasenewvehiclename, xjp_repurchasenewvehiclename),
	xjp_seconddeductible = ISNULL(@xjp_seconddeductible, xjp_seconddeductible),
	xjp_seconddeductible_base = ISNULL(@xjp_seconddeductible_base, xjp_seconddeductible_base),
	xjp_temporaryloanercar = ISNULL(@xjp_temporaryloanercar, xjp_temporaryloanercar),
	xjp_temporaryloanercarname = ISNULL(@xjp_temporaryloanercarname, xjp_temporaryloanercarname),
	xjp_vehicleinspectionexpirationdate = ISNULL(@xjp_vehicleinspectionexpirationdate, xjp_vehicleinspectionexpirationdate),
	xto_discount = ISNULL(@xto_discount, xto_discount),
	xto_discount_base = ISNULL(@xto_discount_base, xto_discount_base),
	xto_quantity = ISNULL(@xto_quantity, xto_quantity),
	xts_address1 = ISNULL(@xts_address1, xts_address1),
	xts_address2 = ISNULL(@xts_address2, xts_address2),
	xts_address3 = ISNULL(@xts_address3, xts_address3),
	xts_address4 = ISNULL(@xts_address4, xts_address4),
	xts_agelimiteddriver = ISNULL(@xts_agelimiteddriver, xts_agelimiteddriver),
	xts_agencychannelid = ISNULL((CASE WHEN @xts_agencychannelid = cast(cast(0 as binary) as uniqueidentifier) THEN NULL ELSE @xts_agencychannelid END), xts_agencychannelid),
	xts_agencychannelidname = ISNULL(@xts_agencychannelidname, xts_agencychannelidname),
	xts_apppointmentid = ISNULL((CASE WHEN @xts_apppointmentid = cast(cast(0 as binary) as uniqueidentifier) THEN NULL ELSE @xts_apppointmentid END), xts_apppointmentid),
	xts_apppointmentidname = ISNULL(@xts_apppointmentidname, xts_apppointmentidname),
	xts_baseprice = ISNULL(@xts_baseprice, xts_baseprice),
	xts_baseprice_base = ISNULL(@xts_baseprice_base, xts_baseprice_base),
	xts_birthday = ISNULL(@xts_birthday, xts_birthday),
	xts_bodilyinjuryliabilitycompensationamount = ISNULL(@xts_bodilyinjuryliabilitycompensationamount, xts_bodilyinjuryliabilitycompensationamount),
	xts_bodilyinjuryliabilitycompensationamount_base = ISNULL(@xts_bodilyinjuryliabilitycompensationamount_base, xts_bodilyinjuryliabilitycompensationamount_base),
	xts_bodilyinjuryliabilityunlimitedcoverage = ISNULL(@xts_bodilyinjuryliabilityunlimitedcoverage, xts_bodilyinjuryliabilityunlimitedcoverage),
	xts_bodilyinjuryliabilityunlimitedcoveragename = ISNULL(@xts_bodilyinjuryliabilityunlimitedcoveragename, xts_bodilyinjuryliabilityunlimitedcoveragename),
	xts_businessunitid = ISNULL((CASE WHEN @xts_businessunitid = cast(cast(0 as binary) as uniqueidentifier) THEN NULL ELSE @xts_businessunitid END), xts_businessunitid),
	xts_businessunitidname = ISNULL(@xts_businessunitidname, xts_businessunitidname),
	xts_categoryid = ISNULL((CASE WHEN @xts_categoryid = cast(cast(0 as binary) as uniqueidentifier) THEN NULL ELSE @xts_categoryid END), xts_categoryid),
	xts_categoryidname = ISNULL(@xts_categoryidname, xts_categoryidname),
	xts_chasismodel = ISNULL(@xts_chasismodel, xts_chasismodel),
	xts_chasisnumber = ISNULL(@xts_chasisnumber, xts_chasisnumber),
	xts_cityid = ISNULL((CASE WHEN @xts_cityid = cast(cast(0 as binary) as uniqueidentifier) THEN NULL ELSE @xts_cityid END), xts_cityid),
	xts_cityidname = ISNULL(@xts_cityidname, xts_cityidname),
	xts_configurationid = ISNULL((CASE WHEN @xts_configurationid = cast(cast(0 as binary) as uniqueidentifier) THEN NULL ELSE @xts_configurationid END), xts_configurationid),
	xts_configurationidname = ISNULL(@xts_configurationidname, xts_configurationidname),
	xts_countryid = ISNULL((CASE WHEN @xts_countryid = cast(cast(0 as binary) as uniqueidentifier) THEN NULL ELSE @xts_countryid END), xts_countryid),
	xts_countryidname = ISNULL(@xts_countryidname, xts_countryidname),
	xts_defaultprice = ISNULL(@xts_defaultprice, xts_defaultprice),
	xts_defaultprice_base = ISNULL(@xts_defaultprice_base, xts_defaultprice_base),
	xts_driverlimitationcategory = ISNULL(@xts_driverlimitationcategory, xts_driverlimitationcategory),
	xts_driverlimitationcategoryname = ISNULL(@xts_driverlimitationcategoryname, xts_driverlimitationcategoryname),
	xts_exteriorcolorid = ISNULL((CASE WHEN @xts_exteriorcolorid = cast(cast(0 as binary) as uniqueidentifier) THEN NULL ELSE @xts_exteriorcolorid END), xts_exteriorcolorid),
	xts_exteriorcoloridname = ISNULL(@xts_exteriorcoloridname, xts_exteriorcoloridname),
	xts_gender = ISNULL(@xts_gender, xts_gender),
	xts_gendername = ISNULL(@xts_gendername, xts_gendername),
	xts_insuranceannualpremium = ISNULL(@xts_insuranceannualpremium, xts_insuranceannualpremium),
	xts_insuranceannualpremium_base = ISNULL(@xts_insuranceannualpremium_base, xts_insuranceannualpremium_base),
	xts_insurancecarusagepurpose = ISNULL(@xts_insurancecarusagepurpose, xts_insurancecarusagepurpose),
	xts_insurancecarusagepurposename = ISNULL(@xts_insurancecarusagepurposename, xts_insurancecarusagepurposename),
	xts_insurancecompanyid = ISNULL((CASE WHEN @xts_insurancecompanyid = cast(cast(0 as binary) as uniqueidentifier) THEN NULL ELSE @xts_insurancecompanyid END), xts_insurancecompanyid),
	xts_insurancecompanyidname = ISNULL(@xts_insurancecompanyidname, xts_insurancecompanyidname),
	xts_insurancecompanyname = ISNULL(@xts_insurancecompanyname, xts_insurancecompanyname),
	xts_insurancegrade = ISNULL(@xts_insurancegrade, xts_insurancegrade),
	xts_insurancepaymentmethodid = ISNULL((CASE WHEN @xts_insurancepaymentmethodid = cast(cast(0 as binary) as uniqueidentifier) THEN NULL ELSE @xts_insurancepaymentmethodid END), xts_insurancepaymentmethodid),
	xts_insurancepaymentmethodidname = ISNULL(@xts_insurancepaymentmethodidname, xts_insurancepaymentmethodidname),
	xts_insuredname = ISNULL(@xts_insuredname, xts_insuredname),
	xts_insurednameid = ISNULL((CASE WHEN @xts_insurednameid = cast(cast(0 as binary) as uniqueidentifier) THEN NULL ELSE @xts_insurednameid END), xts_insurednameid),
	xts_insurednameidname = ISNULL(@xts_insurednameidname, xts_insurednameidname),
	xts_insurednameidyominame = ISNULL(@xts_insurednameidyominame, xts_insurednameidyominame),
	xts_interiorcolorid = ISNULL((CASE WHEN @xts_interiorcolorid = cast(cast(0 as binary) as uniqueidentifier) THEN NULL ELSE @xts_interiorcolorid END), xts_interiorcolorid),
	xts_interiorcoloridname = ISNULL(@xts_interiorcoloridname, xts_interiorcoloridname),
	xts_lastcontractid = ISNULL((CASE WHEN @xts_lastcontractid = cast(cast(0 as binary) as uniqueidentifier) THEN NULL ELSE @xts_lastcontractid END), xts_lastcontractid),
	xts_lastcontractidname = ISNULL(@xts_lastcontractidname, xts_lastcontractidname),
	xts_leaddate = ISNULL(@xts_leaddate, xts_leaddate),
	xts_locking = ISNULL(@xts_locking, xts_locking),
	xts_manufacturerid = ISNULL((CASE WHEN @xts_manufacturerid = cast(cast(0 as binary) as uniqueidentifier) THEN NULL ELSE @xts_manufacturerid END), xts_manufacturerid),
	xts_manufactureridname = ISNULL(@xts_manufactureridname, xts_manufactureridname),
	xts_parentbusinessunitid = ISNULL((CASE WHEN @xts_parentbusinessunitid = cast(cast(0 as binary) as uniqueidentifier) THEN NULL ELSE @xts_parentbusinessunitid END), xts_parentbusinessunitid),
	xts_parentbusinessunitidname = ISNULL(@xts_parentbusinessunitidname, xts_parentbusinessunitidname),
	xts_periodofinsurance = ISNULL(@xts_periodofinsurance, xts_periodofinsurance),
	xts_periodofinsurancelabel = ISNULL(@xts_periodofinsurancelabel, xts_periodofinsurancelabel),
	xts_periodofinsurancename = ISNULL(@xts_periodofinsurancename, xts_periodofinsurancename),
	xts_periodofinsurancevalue = ISNULL(@xts_periodofinsurancevalue, xts_periodofinsurancevalue),
	xts_personinchargeid = ISNULL((CASE WHEN @xts_personinchargeid = cast(cast(0 as binary) as uniqueidentifier) THEN NULL ELSE @xts_personinchargeid END), xts_personinchargeid),
	xts_personinchargeidname = ISNULL(@xts_personinchargeidname, xts_personinchargeidname),
	xts_phonenumber = ISNULL(@xts_phonenumber, xts_phonenumber),
	xts_policynumber = ISNULL(@xts_policynumber, xts_policynumber),
	xts_postalcode = ISNULL(@xts_postalcode, xts_postalcode),
	xts_potentialcontactid = ISNULL((CASE WHEN @xts_potentialcontactid = cast(cast(0 as binary) as uniqueidentifier) THEN NULL ELSE @xts_potentialcontactid END), xts_potentialcontactid),
	xts_potentialcontactidname = ISNULL(@xts_potentialcontactidname, xts_potentialcontactidname),
	xts_potentialcontactidyominame = ISNULL(@xts_potentialcontactidyominame, xts_potentialcontactidyominame),
	xts_potentialcustomernumber = ISNULL(@xts_potentialcustomernumber, xts_potentialcustomernumber),
	xts_productid = ISNULL((CASE WHEN @xts_productid = cast(cast(0 as binary) as uniqueidentifier) THEN NULL ELSE @xts_productid END), xts_productid),
	xts_productidname = ISNULL(@xts_productidname, xts_productidname),
	xts_propertydamageliabilitycompensationamount = ISNULL(@xts_propertydamageliabilitycompensationamount, xts_propertydamageliabilitycompensationamount),
	xts_propertydamageliabilitycompensationamount_base = ISNULL(@xts_propertydamageliabilitycompensationamount_base, xts_propertydamageliabilitycompensationamount_base),
	xts_propertydamageliabilityunlimitedcoverage = ISNULL(@xts_propertydamageliabilityunlimitedcoverage, xts_propertydamageliabilityunlimitedcoverage),
	xts_propertydamageliabilityunlimitedcoveragename = ISNULL(@xts_propertydamageliabilityunlimitedcoveragename, xts_propertydamageliabilityunlimitedcoveragename),
	xts_proposedinsurancecompanyid = ISNULL((CASE WHEN @xts_proposedinsurancecompanyid = cast(cast(0 as binary) as uniqueidentifier) THEN NULL ELSE @xts_proposedinsurancecompanyid END), xts_proposedinsurancecompanyid),
	xts_proposedinsurancecompanyidname = ISNULL(@xts_proposedinsurancecompanyidname, xts_proposedinsurancecompanyidname),
	xts_proposeinsurancecompanyname = ISNULL(@xts_proposeinsurancecompanyname, xts_proposeinsurancecompanyname),
	xts_provinceid = ISNULL((CASE WHEN @xts_provinceid = cast(cast(0 as binary) as uniqueidentifier) THEN NULL ELSE @xts_provinceid END), xts_provinceid),
	xts_provinceidname = ISNULL(@xts_provinceidname, xts_provinceidname),
	xts_relatedexpirationdate = ISNULL(@xts_relatedexpirationdate, xts_relatedexpirationdate),
	xts_relatedperiodeofinsuranceid = ISNULL((CASE WHEN @xts_relatedperiodeofinsuranceid = cast(cast(0 as binary) as uniqueidentifier) THEN NULL ELSE @xts_relatedperiodeofinsuranceid END), xts_relatedperiodeofinsuranceid),
	xts_relatedperiodeofinsuranceidname = ISNULL(@xts_relatedperiodeofinsuranceidname, xts_relatedperiodeofinsuranceidname),
	xts_salesobjective = ISNULL(@xts_salesobjective, xts_salesobjective),
	xts_salesobjectivename = ISNULL(@xts_salesobjectivename, xts_salesobjectivename),
	xts_salespersonid = ISNULL((CASE WHEN @xts_salespersonid = cast(cast(0 as binary) as uniqueidentifier) THEN NULL ELSE @xts_salespersonid END), xts_salespersonid),
	xts_salespersonidname = ISNULL(@xts_salespersonidname, xts_salespersonidname),
	xts_sourceinformationid = ISNULL((CASE WHEN @xts_sourceinformationid = cast(cast(0 as binary) as uniqueidentifier) THEN NULL ELSE @xts_sourceinformationid END), xts_sourceinformationid),
	xts_sourceinformationidname = ISNULL(@xts_sourceinformationidname, xts_sourceinformationidname),
	xts_statusreasonid = ISNULL((CASE WHEN @xts_statusreasonid = cast(cast(0 as binary) as uniqueidentifier) THEN NULL ELSE @xts_statusreasonid END), xts_statusreasonid),
	xts_statusreasonidname = ISNULL(@xts_statusreasonidname, xts_statusreasonidname),
	xts_styleid = ISNULL((CASE WHEN @xts_styleid = cast(cast(0 as binary) as uniqueidentifier) THEN NULL ELSE @xts_styleid END), xts_styleid),
	xts_styleidname = ISNULL(@xts_styleidname, xts_styleidname),
	xts_vehiclebrandid = ISNULL((CASE WHEN @xts_vehiclebrandid = cast(cast(0 as binary) as uniqueidentifier) THEN NULL ELSE @xts_vehiclebrandid END), xts_vehiclebrandid),
	xts_vehiclebrandidname = ISNULL(@xts_vehiclebrandidname, xts_vehiclebrandidname),
	xts_vehicledrivinglicensetype = ISNULL(@xts_vehicledrivinglicensetype, xts_vehicledrivinglicensetype),
	xts_vehicledrivinglicensetypeid = ISNULL((CASE WHEN @xts_vehicledrivinglicensetypeid = cast(cast(0 as binary) as uniqueidentifier) THEN NULL ELSE @xts_vehicledrivinglicensetypeid END), xts_vehicledrivinglicensetypeid),
	xts_vehicledrivinglicensetypeidname = ISNULL(@xts_vehicledrivinglicensetypeidname, xts_vehicledrivinglicensetypeidname),
	xts_vehicledrivinglicensetypelabel = ISNULL(@xts_vehicledrivinglicensetypelabel, xts_vehicledrivinglicensetypelabel),
	xts_vehicledrivinglicensetypename = ISNULL(@xts_vehicledrivinglicensetypename, xts_vehicledrivinglicensetypename),
	xts_vehicledrivinglicensetypevalue = ISNULL(@xts_vehicledrivinglicensetypevalue, xts_vehicledrivinglicensetypevalue),
	xts_vehicleidentificationid = ISNULL((CASE WHEN @xts_vehicleidentificationid = cast(cast(0 as binary) as uniqueidentifier) THEN NULL ELSE @xts_vehicleidentificationid END), xts_vehicleidentificationid),
	xts_vehicleidentificationidname = ISNULL(@xts_vehicleidentificationidname, xts_vehicleidentificationidname),
	xts_vehicleincidentalcategory = ISNULL(@xts_vehicleincidentalcategory, xts_vehicleincidentalcategory),
	xts_vehicleincidentalcategoryname = ISNULL(@xts_vehicleincidentalcategoryname, xts_vehicleincidentalcategoryname),
	xts_vehicleincidentcategoryid = ISNULL((CASE WHEN @xts_vehicleincidentcategoryid = cast(cast(0 as binary) as uniqueidentifier) THEN NULL ELSE @xts_vehicleincidentcategoryid END), xts_vehicleincidentcategoryid),
	xts_vehicleincidentcategoryidname = ISNULL(@xts_vehicleincidentcategoryidname, xts_vehicleincidentcategoryidname),
	xts_vehiclemodelid = ISNULL((CASE WHEN @xts_vehiclemodelid = cast(cast(0 as binary) as uniqueidentifier) THEN NULL ELSE @xts_vehiclemodelid END), xts_vehiclemodelid),
	xts_vehiclemodelidname = ISNULL(@xts_vehiclemodelidname, xts_vehiclemodelidname),
	xts_vehiclename = ISNULL(@xts_vehiclename, xts_vehiclename),
	xts_vehiclevalue = ISNULL(@xts_vehiclevalue, xts_vehiclevalue),
	xts_vehiclevalue_base = ISNULL(@xts_vehiclevalue_base, xts_vehiclevalue_base),
	xts_villageandstreetid = ISNULL((CASE WHEN @xts_villageandstreetid = cast(cast(0 as binary) as uniqueidentifier) THEN NULL ELSE @xts_villageandstreetid END), xts_villageandstreetid),
	xts_villageandstreetidname = ISNULL(@xts_villageandstreetidname, xts_villageandstreetidname),
	xts_whileintheinsuredvehicleonlycoverage = ISNULL(@xts_whileintheinsuredvehicleonlycoverage, xts_whileintheinsuredvehicleonlycoverage),
	xts_whileintheinsuredvehicleonlycoveragename = ISNULL(@xts_whileintheinsuredvehicleonlycoveragename, xts_whileintheinsuredvehicleonlycoveragename)
WHERE opportunityid = @opportunityid